1 1 1 1 1 1 1 1 1 1
1 1 1 1 1 4 5 1 1 1
1 5 0 0 3 3 0 1 1 1
1 5 0 0 1 0 0 5 1 1
1 1 0 3 3 0 0 5 1 1
1 1 5 0 0 0 0 5 1 1
1 1 1 1 5 0 3 5 1 1
1 1 1 1 1 1 0 5 1 1
1 1 1 1 1 1 5 5 1 1
1 1 1 1 1 1 1 1 1 1