1 1 1 1 1 1 1 1 1 1
1 1 5 4 5 1 1 1 1 1
1 1 5 5 5 1 1 1 1 1
1 5 0 0 0 0 5 1 1 1
1 5 3 3 3 3 5 1 1 1
1 1 5 5 5 1 1 1 1 1
1 1 1 1 1 1 1 1 1 1
1 1 1 1 1 1 1 1 1 1
1 1 1 1 1 1 1 1 1 1
1 1 1 1 1 1 1 1 1 1